#.##################
#...............--##
#####-##-##~###.#--#
#-###-#--##~##-.#-##
#-#---#########.#--#
#---#----#-##-#.####
#-####-#-------...-#
#-##---##########.##
#----#--##-------...
##################@#
