#.######################################################################################################################################################################################################
#.........#-#-##------#--##----##-##-----##--------#-#--##---##-------##--##--##-----#--#-#-##---#-####-##--##--#-##------#-#-##--####---#----#-##--#--##---#-####---##-#----##-##-#-#--##---#-----#-#-#
#-#######.#-#-#######---####-###--###-############-----##--##########-##-###-#######-#-##---####-#--##--#--####-#-######-##-#--##--##--###-####-###-##-#--#----##--###--#-####---#-#-##-#--###-###-#---#
#---#-##-...#-#~#--#--#-##-#--###--##-#-##-#-#-#-###-#-#--##-#-#------#--##---#-#--#-#-####--##--#-####-#-##-#-----##--#------##--##--##---#-##--##-##-#-#########-#-##----#-##-##----#-#-####-#-###-###
###-#--#-##.#-#~##-##-#------##-##-##-#-----------#--####-#--#-###-##---#####---##-#------##--##-#--##----##---###--##-#-##-###--####-#--#----#-###--#-#-#-###-##-------####-#--##-####----------##----#
##----##-#-....~##-####-#-##-##--#-##-#-#-##-####-##--##----##-########-#-#####-#--##-#######-##---##--#######---#####-#--#--##-##-##---####-##-#-##---#-------####-#-#--##--#-##--##---##-##-#-####-###
#--##----##-##.##--#-#######-###----#-#########---###--#-#####---##-------#--##-##-##--##-#-#-##-#####---##--###-##--#---######-##-##-########----####-#-###-###-##-#######-##--##--##-########-##-----#
#-####-#----#-.~##-#-#-#-#-#-#-##-#----#-#--#---#--##-##-###-##-#######-###-##------#-##--#-#-##--##-#-###--##----##-##-###---#-##-##---##-##--####-##-----#--##-----#-##-#----###-##--##-##-##--###-###
#-#-#####-####.##----#-#-#------######-#-##---#-##----##---#-##-#-#-#----#---#####-##-###-#------##--#--###--##-###--##---##-##-##----#-#---#-##-##--#-##-########-###----#-####-#--##-##-----####-----#
#---#-#---##-#.~#-##-#---######-##-###-#-######-#####-##-###--#---#-####-##-####---##--##-#-########---##-##-##---##--#-###--##--#-####-###-#-----##-#--###-#--##---###-###---#--#-###----#####--###-###
###---###-#---.#####-#-###---------------#-###---##-#------##-#-###-##------##-###-##-##--#-###-#-#--###--##-##-#####-#-##--####------#####---#-#-#--#-####---##--###---###-###-##-#-#-####-#-##-#-----#
#-###--#--####.~##-----#############-###-#-#-#####--###-#####---##--#######-----##-#---##---------##-#-#-###-##---##--#-##-###---##-#--##-##-#######-#-##-##-####-#-###-#-#-##--##-#-----#----##-#-#####
#-#-##-##-##-#.######-##-##----##-#--###-#-#--##-##-#----###--###--##--#--#####-#--#-###--###-#-####-#-#--#--##-#####---##-#---##########-#----#-##-----#--#-#-#--#--##------##--#-#-#####-####--------#
#-------#-#--#.#-##----#--####-##---##-------##--##-###-##-##---##--##-#-###-#--##---#-##-#-######---#---##-###-##-##-###----####-##-###----####-##-###---##-#-##-#-##--##-###--##-#-#--------##-###-#-#
#######-#-##-#....####-#-##-#---###-########-##-##--##-----##-####-##----##--##-####-#-#----##-#-###---####-#-#--#-##-#-##-###--#-#--#-###-##-##-##--####-##-----------###---##-##-----######-##--####-#
#-#-##-------#-##.#-#--#--#-#-###----##--##--##-##-##--###------#---####--##-##------#-##-#--------###-#-#----##------#-##--##-##-#-##-#-#-##-##-##-##-########-###-##---##-##---##-#####-#-#-##-##-##-#
#-#--#-##-##-#-#-.#-##---##-#-#-####-###-#--##------##-#-#####-##-###----##---######-#-#--#-########---#---#####-######--##--#------##---#-##-##-#--#--#-#-##----#####-#--######-##-##----#-####-----###
#---##-##-#----##.#--###-##-----##----#----########-####-##----##-#-####--##-###-###-#-##-####-##--###-#-######--##--##-####---#########-#-#--#--#-##-##-#-####-##-#-####--##--------#-##----#-#-##-####
###--#-##-#-##---.#-##-#--####-######-####--##-#----#-#---####--#-#-#-#--##--##--#-#-#-#---#----#-###------#--##--##-##-#-##-####-----##-#-##---##-##-#-----##-------########-###-##----#-####-#--####-#
#---##-#-----#-##.#-#----##----#-##-#-###--##--####-#-##-##--##---#-#-#-####--##-#---#-#-###-####-#-##-#####-###-###--#-#-------#-#####--#--#-###---#-#-#####--#######-#--##----######-##-#-##-##------#
##-##--#####-#-#-.#-##~#####-#-#-##-#---##-##-##-#--------##-##-#-------#-#--###-###-----##----##-#-#--#--##-##----#-##-#-#######--##-##-#-##--####-#-#--#--##----##---#-####-#-######-####-#-----######
#---##-#-###---##......#-#-#-#---#--#-###--#-----#-#####-###-##-##-#-#-##-##-##--#-###-###--####----##-#-###-#####-#-##-#-------##--#-##-#-#--##-##-#-#-##-##--####--###-##-#-###-##-###-#----#-#-#-#-##
###-##-#-#-###--######.#---#####---##-#-##-###-#####-#-#-##------#####--#-#---##----#---##-##-####-##--#--#---###--#-##-#-#######--##-##-#-#-##---#-#---##--##--#-#-####-##-#---#--------###-####-#----#
###-##-----#-#-###-###.#-#-##--###--#-#-#--#----#-#-------######-##-###-#-#-#####-#---#--#-##--##---##-#-##-#-#-##---##-#-#--##-##-##-##-#-#--##-##---#--#-##--##---##-#-##---###-########-----####-####
#---####-###-#-##--#--.#-#####-####-#-#-##-###-##-######-###-##------##---#-###-####-#####-##-###-###-----#-###-##-####-#-#-##---#-##-##---#-##---#-###-##-###----#--#-#--#-#-#-#-##-##-####-###-##-##-#
###-#-----##-#--##-###....##---#-#------##-#-#-#--#-#-#---#---#-####--###-----#-##-#-#-##------#---######-#-##--#---#-#-#----##-##-##--###----##-##---#-##--##-#######---##-###-#--#-----#-#--#--##--#-#
###-#####--#-##-#---#####..###---######--#-#-#---##-#-###-##-########-#-###-###--#-#----##-#####-###-##------##-#-###-#-#-####--##-###-----#-##-----#######--#---#-##--###---##-#-##-#####-#-##-##--##-#
#----##-#-##-#--###-#-####.#---###-#----##-#-##-##--#-##---#-#-##---#-#-#-#-#-##-----####---#-##-##--#####-#--#-#--##-#-#---###-##-#-##-#-####--#-####-#--##-#-###-##-##-###-##----#----##-------##-#--#
##-#-------#-##-#-#-#-#---.###--#--####-##-#-#---##----###-#-#-##-#------------#####---###-##--#--##---######-#-#-##--#-#-###-#-##-#-##-###-##-######--#-##--------------#-#-##-####-#####-##-####----##
####-#-#-#------------####.#-#-##-##-------#-###--##-####-------#####-##-##-#####--##-##---##-##-##--###--##-------##-#---#-#-#-#--#-----##----#-##-##-#--##-##-####-#-#-#-#----##-----#-#--####-##-####
#-#--#-####-#########-#-#-.#-#--#--#####------###------#--#-#####---######---#--#-###--##-###-##-##-##-##-###-######----###-#-#---##-#####--####-#--##-##--#--#---##-#####-####--#-#####---###-#--#-##-#
#-###############-------##.#-#-##-##-----#-##---######-#-######~##-##---#--#---##--#--###--#---#-##-##-##----------###-##---#-#-###------##-#-#--##-##-#--##-#############---##-##----##-###-#-#-##--#-#
#-#-#-##-#-#----#######---...#~#---##########-####-##-----###-~~##--###---####--##-##-#-##-#-###--#-##--#####-#-##-#----##-##-----##-#####----#-##--##---###--------#--#-##-##--##-####------#~#~~##~~~#
#-----##-#-###-##-#-----####...##-##--#-#-#----##---####-##-###~##-##-##-##-###-##-#----##-----#-##-##-##-##--######-#####-###-#####---#-#-#-##-##-###-###-##-#######-##-----##-##-##-##-#####~#~###~#~#
##-##---------------###----###.....##.....####--##-##-------#~#~##-----####------#-##-#####-####-#--##----###--#-##----##--#-#----#--###-#-####-##---#--##-----#-#-#---#-#-###--#---#--------#~#~~~#~#~#
#####-###############---##-----#-#....#-#......##--#####-####~~~~#####--#-######---#--##--#-#-##-#-######--##-##--##-#####-----#-##-##-#----##--##-###-###-#-#-----#-#####-#-##---#---########~##~##~###
#------#########-#-####-###-#-#####-#####-####..##-#-#---##-#~####---##-#--#####-#-##-##-##--------#-#-##-###-##-##---#-####-######--#-#-######-#---#--##--####-####-#-##----#~~#-##-##-##~~##~~#~#~~~##
######---------------##--####-##----##-#---#-##.##-#-###-##-#~#~~###-#----##---#-#--#-##-####-######---##-#---##--##-##-#-#--##-##--##-----##---#-###-###-###-#---##---#####~#~#####----##~###~##~~~#~~#
#------############-##--##-#---#-#-##----#----#.#.........#~~~~~##---###-#####-####-#-----##---##-####-##-###-#--##-------##--#-###-#--#######-##-#-#-#-------#-###--###~##~~#~~##~######~~#~#~##~######
#########-#------------##----#-########-#####--...##-##-#..~#######-##----##-#-##---###-####-#-#-----#-#---##-##-###-######--##--##-#-###-#-#--##-#-#-#-############-##~~~~~##~##~~~#~~###~#~~~~#~#~####
#---------#-#-##-#-#-#-#####-#####---#####--##-#-##--#--##.##-#-##---####--#-#--###--##-##---###-#####---####-#----#-##---##--#-##------#---##--#-#-#----------##-#--##~#####~~~##~##~##~#~~~##~#~#~~~~#
#####-#-#---####-###-###------##-###---#-##--#############.#----##-####-##-#-#-##---##---#-####--###-#-###-#--##-###-#--###--##--###-####-###--##-#---###-#-#-##--#~##~~##~##~####~~#~~#~#~#~~#~#~~~##~#
##-###########---#-----##-#####------#----##-##-#-#-#-##--...#####--##---#-#-#-##-#--###----#-##---#-#-##--#-##---##---##-#-###-##-#--##----##------#############~#~~#~##~~#~~~~~~~##~##~#~#######~#####
#---##-##------#-##-##-##-#-----#-##-####----#---------#-###..##-##--###-#---#-####-##---#-##-#--###-#--##-#-###-####-##------#-##---###-#####-###-####-##-#-###~~##~~~~##~#~#~#~#~~~~~~~~~~##~##~~~~~~#
##-##---###-##-#--####--#####-#########-##-#-########-####-##.~#--#-##-----###--##---###-####-#-###----##--#--#--#-#--##-######----###-#-#-##---####-----#-#--#~~##~~#####~#~######~###~###~~~~~~~#~#~##
#--####--#--##-##-#--##-##----#---------------###------##--#-.##-##-####-#---##-###-##-#--##----#-#-#-####-#-##-##---###--#-###-##-----#-#-##-###-###-####-##~~~####~~~##~~~~~#~##~~~~#~~~#~##~#~##~####
##---###-#####-#--##-------#-##-######-######-#-######-###-##.##--#-#-######-##-#-#-##-#-####-###-###-#--#---#---###-#-#-##-#-#-########----#-#----#--##---##~###~#~~###~~###~~~~###~##~##############~#
#--#-#----##-####--###-###########-----##---------------##-#-..##------##-##-##---#-##----##--#---##--##-#-###-###-------##-#-#-#-#----##-###---##---##--####~~##~~~##~##~~~#~####~###~~~~~~~~~~~~~##~~#
##-######----##-##-#####-##-#-##-#####-################------#.##-#######-#---###-#-####-##--##-#####------#-#-#-###---###----------#####---#-######--##--#~##~~##~###~~#~###~~~~~~~~##~###~###~####~~##
#--##-##--####--####--#--##-#-#--------#-----###--#--####-#-##....~##-##--##-##-#---#-##--##-##---#-#-####---#---####-##-#-###########----#-#-#-#######-~##~~#~##~~~~##~#~###################~####~#~###
##--#-###-#-#--##-###---##----#######-####-#---##-##------###--##.##--###-----#-##-##----##---#-###-####-###-#-###--#-#----##-####-----#-####----#----##~##~##~##~####~~~~~~~~~######~~~#~~##~~#~~~~~~~#
###-#-#-#-#-#-###-#-###-###-#---##-####-######-#-----##-#-######-..##--######-#-##-#####--##-##--#--##---##------##-----#-###------###-#-#-##-##-#-#####~~~~~#~~#~~#~#~#########~~~~~~###~####~~~#######
#-----------#-##--#-----#-#####-##--------#-##---#-###--#-#---#--#....##~#-#--#-#----####-----##---####-####-###--##-#######--####---#####--#-####--##~#~#####~##~##~~~~~~###~~~~######~~~~##~~#~###~~~#
#-#######-###--##-###-#---##-------##-###------#-#-#---##-###-##-#-##..~~#-##---####----##-######-##--#---##-#-####---##-----##########-##-##---##-###~#~##~~~~~~~~##~###~~~#~####~##~#~######~###~#~###
#--##-----#---##--##--###--#####-#-######-#-##-#-#-##-######--########.###-#--###--#-####--#-##-#--##-###-##----##--###--#####---####-#-##-#--####---#~#~##~#########~~~#####~~~##~#~~~~~~~#~#~~##~#~~~#
########-##-#####--######-##-#######-#----#-####-#######-#---##-#-#-##.##--##-#-##----#-##-#-#----##---#--##-######---#-###-###-##--#-#-#--#-##----###~~~~~~~##~###~#~#~##~~~~###~~~~###~###~~~###~#~###
##-#------#--##-##---##----#-#-##-##-######-#-#####------###----#-#-##.~##-#-----##-###----#---#######-##-#---#####-###------#-----##---##----#-####~#~#####~~~~~~~~~~#~~~~##~~~#~##~~~#######~#~#~#~###
#--######-#-##--##-#--####-#----#----##-##--#---#-######--###-#-----##.###-##-#####--#####-#-###--#-#--##-#-###-##------#-##-#-#####--###--####---##~~~####~~#~##~##~###~####~###~~#~#~~##~#~~~#~~~~~~~#
##-#-#----#-###-##-####-##-####---##-----######------####-----#-###---........#-##--##---#----#--##-#-##--#-###--##-##########---#---##-##-#-#--#-##~#~~~~#~##########~####~###~~~########~#~###~###~###
#------##-#-#-#-#---##----------#-######-#-#-#######------#-#-#--###-######-#.#--##-####---##-#-##--#-###-#-#-##-------#-##-#--###-#-#--##-----#######~#######~~###~#~~##~~~~~##~###~~#~#~~~~##~~~~#~~~#
####-#-#----------#######-#-#-#-#-#--------#--###-#######-###-#-##-#####-####.#-##--#--###--###--##----##-#----##-######-#--##-----#-#-##--#####-#-##~~~#~##~##~~~#~~~###~######~~~##~~~#~####~~#~##~###
###--#-#-#-######------#############-#-#-#---##-#-#-#---#-##--####-##-----##-......##-##---#####--####-##-#-#####----------##--#######-###---------####~~~#~~~##~##~###~#~~#~##~~####~###~#~~~~##~~#~~~#
#-##-############-######-#--#####--###-#####--#-#---###----#-###------###----#####.##--###-#--##-###-#-#-----##-#-############-#~#~~##--##-#########~~~~###~####~~~~#~#~##~#~#~~##~~#~###~~~##~~#~###~##
#----##-----------##-#-#---##-#-##---####-###-#-###--#--#-####---##-#-#####-##----..##--##-#-##--#---#-#-#####-------##--#-#-#-~~~~##--##-----#~~~~##~#####~~~~#~####~~~#~~~~~~####~#~#~#~#####~#~~#####
#-#-####-##-#-#-#-##-#-###------###-####---##-#-#-##---##--##--#-######------######.##-##--#--##-###---#---##--#######--##-#-##~######--##-####~#####~~~~~#~####~##~#~#~~~##~####~#~#~#~~~~~#~######~#~#
#-#--#-###--###-#--#-#-#-#-##-#---#-##---#----#-#--###-##-###-##-#-#-##-###-##-----.......##-##----###-#-###--##-##-###-##-#...~~~#~#--###-##~#~#~##~~#####~#~#~~~~~~~######~##~#~#~~~~~#~#~~~~#~#~#~~~#
#-####-###########-#-#-#-########----######-#-----##---####----###----########-###-######.##--####-##--#--#--##---#-#-#......#.##~~~##--#---#~~~~~##~##~#~#~#~#~#####~~~~~~#~~~~~~~~#~#~########~#~#~###
####-#-#--###-##-#-#-#-#--#-##----#####-#---###-#-##-###-####-###--##-###--#-###-####--#-..##~~##--###-#-##-##--###-#-#.####~#.#######-##-###~#####~~~~~~~~~~~~~~~~~#~#~#~##~#####~##~#~~#~#####~~~~~~~#
#------##-#----------#-#-##-###-#--#-#--#########-#####---#####-##-#--#-##-#--#--##-##-###..##~~##--##---##-##-##-#-#~#.######...##.......~~~~~~~~~~##~##~#~#~##~##~#~#####~~~~~##~####~##~#~~~##~###~##
###-##----####-#-###---#-##-#-####---##--###-------##-##-##-##--#####---##-##-##-##-##-#-##..~~##--#####..............#.~~~~~###....#####.######~#######~~#~#~~####~#~##~####~#~##~~~~#~##~#~#~##~~~####
#####--##------#-#---#---#----##---#####---####-##--#-#--##-#--##-##--#-------------#--#-###.#####--##...#-#-#-###-##...#~#~##---##----##......######~###~####~~~~#####~~~~##~#~~#~####~##~~~#~##~####~#
#--#--####-###-#-###-#-#-##-#-####--##---####-#####---#-##----##---##-##-##########-##---#-#..#-###--#.#########----##~####~##-#--##-#####-#-#..#~~~#~#~#~~#~##~####~##~####~~#~#####~###~~#####~~~#~#~#
##---##----#---#-#---###-##-###-###--###-##----#-####-#--####----#-########-##-##-#-####-#-##.#---##-#.~~##-#-##########-########-##-##-##-#-##..~#~~~~~##~~~~~~~~~~~~~~~~###~#~~~~~~~~##~##~##~~###~#~#
#--#--###-##-#-#-##-##---##--##--###-###--##-###-#------###-####-###-##-#-#----#----#------#..#-###....####-#-#-----###----##-#-###------#-#####.######~##~#~#~######~#~###~###~######~~~~~~~~~~####~#~#
#-###-##---#############-##-####-#-----##-##--##-####-#-----###---##--#---####-####-###-##--.##-#-#.##~~#-#-#-#-###--#--##------#####-#-######--...######~~#~#~~~~~~#~#~~~~~~####~##~#####~#~##~~~~~~~~#
###------#--#-#-------#------##--##-##-##-##-##---#-###--##-#-###--##-###--#----#-#------###..#-#...#####---------##---##--######-#######-#--#-#-#......######~##~#~###~##~#~~##~~~~~~######~~#~#~#~#~##
#---###-##-##-#######-######--##-#####-#---#-####----#--##-----###--#-#-##---##-----#-##-####.....###-#-#-####-#-##--#-###---##-#----#-##---####-#-#-##...~########~~~#~##~##~~~~####~~~~~~##~#~###~#~~#
######---####-#-#-#-#-#-##-#-###-#-#-#-###----#-####-##--###-#--###-----##-#-#--#-#-######-####-#--#---------#-#--##-#--##-#------##---#--###-####-#--#-#.##----###~###~##~###~#~~###~#~#######~~~###~##
#------#-#---------------------------#-#---##--------##-#######-----#-#-#--######-#-#---#----#--##---###-#######-##--##--######-########-##---#--#-#-####.##~####~#~~#######~~~####~###~~~~~~~##~##~~~~#
###-#-##-#########-#####-#-####-####---###--###-##-#-----#-##-##-##-#-----###-##--#####---##---####-####-------#--#-####--#--##########-----###-######--#....~~~~~##~~~##-##~#~~##~~~##~#~#~###~~~##~#~#
#---######---------##----#####---##--#-----###--#####-##---#---#############-----##-----#-#--#--##-----###############-##---##-#--##----##-##-#-----#--#####.##~########---#~##~~~~###~~###~~~###~#~~#~#
#######-##########-#--####-----#-##-##-###---##-#-----##-#-#-###--#------#-####-#######-#-##-#-###-#-#------#-#--#-##--#--####-#-##--####---#-#-#####-##-##-..#####-##-##-#####~#~#####~~###~##~~~#~##~#
#--------##---#-#####-#----##-##--###----###-#--##-#######---#-##-######---#-##-#-##----####-###---###-##-#-----##--##-##----#-#-#--#######-----##----------#...............#~#~#~~~~~##~~~#~~##~##~##~#
#####-##----#----#----###-##--##-###--##############-#-##--#-------------#----###-#--#-###-----#-#--##########-##--##--####-##-----###----#-#-#--#-##-##-#-##-#####-#######.#~#####~#~##~#~##~##~~#~~#~#
#-----#--#####-#---#####---########--##-----#-###-#--#-#--##-##-##-##########-##--######---##-#####----------#--#-####-#-#####-###-----#-##-####----#########-----#-----##-.~~#######~####~######~#~##~#
#-#-#-######-#-#-#-##----#-#----#---##--#-#-----#-##-----##--#--##-#----#-##---##---#----#-#--##----#####-#-###-#----------#----##############-#######--#-#-#####---#-#####.###-#-#####-##~#-#-#########
#######--------#-#######-#-####---#--##-#####-#------##-####-#-########------#-####---#-##-##--####-----###-##----#-#-#-#-##-##---#-----#-#-----##-#-##------#-########-#-#.#.....#-##---###----##-#---#
##-#-###############-----########-#-##--#-----#-##-#-#---##--#-#--------###-##------#-#--#####--##--##-####--###-####-#-#----####---##-##-##-####-------#-##-#-#-#-#-#-----...#-#....###--#--####----#-#
#-----#-###-###-##-##-######------#--#####-######--#####-##-##-#######-##---#######-#-#-##---##-###-##-#--#-##------#####-##----##-######--#-#----#-##########-#-#-#-#-####-#~####-#.#-#-##-##-##-######
#####-#---#-----##--#####----##-##############--#####-#--##-#--###------###-#-------#-#-##-#------###----##--###-#-###-##-##-#######-##---##-#-####---##-#--##---#---#-#-#######-###............#-###-##
#-----###---#-#----###----##-##-##-#-#--#-#----##-------#####-##---###-##---#-##-#-####--####-#-#--##-#-#######--#-----##-##--##-##---#-###-----#####----#-##--#---#------#####---####-######-#....----#
##-##-#---#-####-#-----####--#--#----##---####-####-#-#-##-##-#--###-###--######-#----#####---#-##-##-#-#-----##-##-##-######-------###-#---###---###-####-##-######-######-#-#-###-##-##-########.#####
#####-#-#-#---#####-##--######-#####----#--#--------###-#-----#####------###-----###-##-----###-####--#---##-##--##--#-----##-#-###-----#-#---###---####-#-#-----------------------------------###.##-##
#-#-----###-###-######-##------------##-##---#-#-##---###-#-#-###-######-##--#-#-#----##-#-##------##-#-#-##########-##-#-###-#--##-#-#---##-##---###--#-----####-###-##-######-####-#-#########...~#--#
#---#-#--##-##---#-#---##-#-#-###-#-###-###-####-##-#######-#-#----##-----##-#####-#-##--#--###-#-###-#-#---#-#---#####-#---###-##--###-#--###--#---##---#-#----#--##--#-----#####-###---####-##.####-##
#-#-###-########-#---#--#-###--##-#-##--#---##---##-##------#-####----##-#####-----#--##-#####--###---###-###-#-###---#-##-##---###-----###########----###-###-#######-#-##-##-##----#-###-----#.......#
###-##--##----#----#########--##--#####-#-###--#-##-###-#-########-#-######-######-#-###-#---##--##-#--##-----------#---##--###--##-#-#---##-###-###-#---####-------##-#-##-#--###-###-----#-#---##-##.#
#---###--####---##-##-#-##-##-##-##-----#-#---####---##-####-##----#-##------------#---###-#----#####-##--###-#-##-##-#-###--##-#####-#-####---------#-#----##-####-##-####---##-#-#-##-#-####-#--#--#.#
#-#-----##----#--#-#-----------#--##-#-##-##-##----#-#--##------#-##-#--#-##-#-#-#-#-#-##--##-#---##---##--##-#-##--#-#---##-##---##--#------##-#-##-#-#-#-##----##--#-##---#-----------#---##-#-##-##..
######################################################################################################################################################################################################@#
