#.######################################################################################################################################################################################################
#.........#~#-##~~~~~~#~~##~~~~##~##~~~~~##~~~~~~~~#~#~~##~~~##~~~~~~~##~~##~~##~~~~~#~~#~#~##~~~#~####-##--##--#-##------#-#-##--####---#----#-##--#--##---#-####~~~##~#~~~~##~##~#~#~~##~~~#~~~~~#~#~#
#-#######.#~#-#######~~~####~###~~###~############~~~~~##~~##########~##~###~#######~#~##~~~####~#~~##--#--####-#-######-##-#--##--##--###-####-###-##-#--#----##~~###~~#~####~~~#~#~##~#~~###~###~#~~~#
#---#-##-...#-#~#--#~~#~##~#~~###~~##~#~##~#~#~#~###~#~#~~##~#~#~~~~~~#~~##~~~#~#~~#~#~####~~##~~#~####-#-##-#-----##--#------##--##--##---#-##--##-##-#-#########~#~##~~~~#~##~##~~~~#~#~####~#~###~###
###-#--#-##.#-#~##-##~#~~~~~~##~##~##~#~~~~~~~~~~~#~~####~#~~#~###~##~~~#####~~~##~#~~~~~~##~~##~#~~##----##---###--##-#-##-###--####-#--#----#-###--#-#-#-###-##~~~~~~~####~#~~##~####~~~~~~~~~~##~~~~#
##----##-#-....~##-####~#~##~##~~#~##~#~#~##~####~##~~##~~~~##~########~#~#####~#~~##~#######~##~~~##--#######---#####-#--#--##-##-##---####-##-#-##---#-------####~#~#~~##~~#~##~~##~~~##~##~#~####~###
#--##----##-##.##--#-#######~###~~~~#~#########~~~###~~#~#####~~~##~~~~~~~#~~##~##~##~~##~#~#~##~#####---##--###-##--#---######-##-##-########----####-#-###-###~##~#######~##~~##~~##~########~##~~~~~#
#-####-#----#~.~##-#-#-#-#~#~#~##~#~~~~#~#~~#~~~#~~##~##~###~##~#######~###~##~~~~~~#~##~~#~#~##~~##-#-###--##----##-##-###---#-##-##---##-##--####-##-----#--##~~~~~#~##~#~~~~###~##~~##~##~##~~###~###
#-#-#####-####.##----#-#-#~~~~~~######~#~##~~~#~##~~~~##~~~#~##~#~#~#~~~~#~~~#####~##~###~#~~~~~~##--#--###--##-###--##---##-##-##----#-#---#-##-##--#-##-########~###~~~~#~####~#~~##~##~~~~~####~~~~~#
#---#-#---##~#.~#-##-#---######~##~###~#~######~#####~##~###~~#~~~#~####~##~####~~~##~~##~#~########---##-##-##---##--#-###--##--#-####-###-#-----##-#--###~#~~##~~~###~###~~~#~~#~###~~~~#####~~###~###
###---###-#~~~.#####-#-###~~~~~~~~~~~~~~~#~###~~~##-#~~~~~~##~#~###~##~~~~~~##~###~##~##~~#~###~#~#--###--##-##-#####-#-##--####------#####---#-#-#--#-####~~~##~~###~~~###~###~##~#~#~####~#~##~#~~~~~#
#-###--#--####.~##-----#############~###~#~#~#####--###~#####~~~##~~#######~~~~~##~#~~~##~~~~~~~~~##-#-#-###-##---##--#-##-###---##-#--##-##-#######-#-##-##~####~#~###~#~#~##~~##~#~~~~~#~~~~##~#~#####
#-#-##-##-##-#.######-##-##~~~~##~#~~###~#~#~~##-##-#~~~~###~~###~~##~~#~~#####~#~~#~###~~###~#~####-#-#--#--##-#####---##-#---##########-#----#-##-----#--#~#~#~~#~~##~~~~~~##~~#~#~#####~####~~~~~~~~#
#-------#-#--#.#-##----#--####~##~~~##~~~~~~~##--##-###~##~##~~~##~~##~#~###~#~~##~~~#~##~#~######---#---##-###-##-##-###----####-##-###----####-##-###---##~#~##~#~##~~##~###~~##~#~#~~~~~~~~##~###~#~#
#######-#-##-#....####-#-##~#~~~###~########~##-##--##~~~~~##~####~##~~~~##~~##~####~#~#~~~~##~#~###---####-#-#--#-##-#-##-###--#-#--#-###-##-##-##--####-##~~~~~~~~~~~###~~~##~##~~~~~######~##~~####~#
#-#-##-------#-##.#-#--#--#~#~###~~~~##~~##~~##-##-##~~###~~~~~~#~~~####~~##~##~~~~~~#~##~#~~~~~~~~###-#-#----##------#-##--##-##-#-##-#-#-##-##-##-##-########~###~##~~~##~##~~~##~#####~#~#~##~##~##~#
#-#--#-##-##-#-#~.#-##---##~#~#~####~###~#~~##------##~#-#####~##~###~~~~##~~~######~#~#~~#~########---#---#####-######--##--#------##---#-##-##-#--#--#-#-##~~~~#####~#~~######~##~##~~~~#~####~~~~~###
#---##-##-#....##.#--###-##~~~~~##~~~~#~~~~########-####-##~~~~##~#~####~~##~###~###~#~##~####~##~~###-#-######--##--##-####---#########-#-#--#--#-##-##-#-####~##~#~####~~##~~~~~~~~#~##~~~~#~#~##~####
###--#-##-#.##....#-##-#--####~######~####~~##-#----#-#---####~~#~#~#~#~~##~~##~~#~#~#~#~~~#~~~~#~###------#--##--##-##-#-##-####-----##-#-##---##-##-#-----##~~~~~~~########~###~##~~~~#~####~#~~####~#
#---##-#---..#~##-#-#----##~~~~#~##~#~###~~##--####-#-##-##~~##~~~#~#~#~####~~##~#~~~#~#~###~####~#~##-#####-###-###--#-#-------#-#####--#--#-###---#-#-#####~~#######~#~~##~~~~######~##~#~##~##~~~~~~#
##-##--#####.#~#--#-##-#####~#~#~##~#~~~##~##-##-#--------##~##~#~~~~~~~#~#~~###~###~~~~~##~~~~##~#~#--#--##-##----#-##-#-#######--##-##-#-##--####-#-#--#~~##~~~~##~~~#~####~#~######~####~#~~~~~######
#---##-#-###...##------#-#-#~#~~~#~~#~###~~#-----#-#####-###~##~##~#~#~##~##~##~~#~###~###~~####~~~~##-#-###-#####-#-##-#-------##--#-##-#-#--##-##-#-#-##~##~~####~~###~##~#~###~##~###~#~~~~#~#~#~#~##
###-##-#-#-###.~######-#---#####~~~##~#~##~###-#####-#-#-##~~~~~~#####~~#~#~~~##~~~~#~~~##~##~####~##--#--#---###--#-##-#-#######--##-##-#-#-##---#-#---##~~##~~#~#~####~##~#~~~#~~~~~~~~###~####~#~~~~#
###-##-----#-#.###-###-#-#-##~~###~~#~#~#~~#----#-#-------######~##~###~#~#~#####~#~~~#~~#~##~~##~~~##-#-##-#-#-##---##-#-#--##-##-##-##-#-#--##-##---#--#~##~~##~~~##~#~##~~~###~########~~~~~####~####
#---####-###-#.##--#---#-#####~####~#~#~##~###-##-######-###-##~~~~~~##~~~#~###~####~#####~##~###~###-----#-###-##-####-#-#-##---#-##-##---#-##---#-###-##~###~~~~#~~#~#~~#~#~#~#~##~##~####~###~##~##~#
###-#-----##-#..##-###----##~~~#~#~~~~~~##~#~#-#--#-#-#---#---#~####~~###~~~~~#~##~#~#~##~~~~~~#~~~######-#-##--#---#-#-#----##-##-##--###----##-##---#-##~~##~#######~~~##~###~#~~#~~~~~#~#~~#~~##~~#~#
###-#####--#-##.#---#####--###~~~######~~#~#~#---##-#-###-##-########~#~###~###~~#~#~~~~##~#####~###~##------##-#-###-#-#-####--##-###-----#-##-----#######~~#~~~#~##~~###~~~##~#~##~#####~#~##~##~~##~#
#----##-#-##-#~.###-#~####-#~~~###-#~~~~##~#~##-##--#-##---#-#-##~~~#~#~#~#~#~##~~~~~####~~~#~##~##~~#####-#--#-#--##-#-#---###-##-#-##-#-####--#-####~#~~##~#~###~##~##~###~##~~~~#~~~~##~~~~~~~##~#~~#
##-#-------#-##.#-#-#~#----###~~#--####~##~#~#---##----###-#-#-##~#~~~~~~~~~~~~#####~~~###~##~~#~~##~~~######-#-#-##--#-#-###-#-##-#-##-###-##-######~~#~##~~~~~~~~~~~~~~#~#~##~####~#####~##~####~~~~##
####-#-#-#-----.......####-#~#~##-##~~~~~~~#~###--##-####-------#####~##~##~#####~~##~##~~~##~##~##~~###--##-------##-#---#-#-#-#--#-----##----#~##~##~#~~##~##~####~#~#~#~#~~~~##~~~~~#~#~~####~##~####
#-#--#-####-#########.#~#--#~#~~#--#####~~~~~~###------#--#-#####~~~######~~~#~~#~###~~##~###~##~##~##-##-###-######----###-#-#---##-#####--####~#~~##~##~~#~~#~~~##~#####~####~~#~#####~~~###~#~~#~##~#
#-###############----...##-#~#~##-##~~~~~#~##~~~######-#-######~##~##~~~#~~#~~~##~~#~~###~~#~~~#~##~##-##----------###-##---#-#-###------##-#-#~~##~##~#~~##~#############~~~##~##~~~~##~###~#~#~##~~#~#
#-#-#-##-#-#----#######......#~#---##########~####-##-----###~~~##~~###~~~####~~##~##~#~##~#~###~~#~##--#####-#-##-#----##-##-----##-#####----#~##~~##~~~###~~~~~~~~#~~#~##~##~~##~####~~~~~~#~#~~##~~~#
#-----##-#-###-##-#-----####...##-##--#-#~#~~~~##---####-##-###~##~##~##~##~###~##~#~~~~##~~~~~#~##~##-##-##--######-#####-###-#####---#-#-#-##~##~###~###~##~#######~##~~~~~##~##~##~##~#####~#~###~#~#
##-##---------------###----###.....##.....####~~##-##-------#~#~##~~~~~####~~~~~~#~##~#####~####~#~~##----###--#-##----##--#-#----#--###-#-####~##~~~#~~##~~~~~#~#~#~~~#~#~###~~#~~~#~~~~~~~~#~#~~~#~#~#
#####-###############---##-----#-#....#-#......##--#####-####~~~~#####~~#~######~~~#~~##~~#~#~##~#~######--##-##--##-#####-----#-##-##-#----##~~##~###~###~#~#~~~~~#~#####~#~##~~~#~~~########~##~##~###
#------#########-#-####-###-#-#####-#####-####..##-#-#---##~#~####~~~##~#~~#####~#~##~##~##~~~~~~~~#-#-##-###-##-##---#-####-######--#-#-######~#~~~#~~##~~####~####~#~##~~~~#~~#~##~##~##~~##~~#~#~~~##
######---------------##--####-##----##-#---#-##.##-#-###-##~#~#~~###~#~~~~##~~~#~#~~#~##~####~######---##-#---##--##-##-#-#--##-##--##-----##~~~#~###~###~###~#~~~##~~~#####~#~#####~~~~##~###~##~~~#~~#
#------############-##--##-#---#-#-##----#----#.#.........#~~~~~##~~~###~#####~####~#~~~~~##~~~##~####-##-###-#--##-------##--#-###-#--#######~##~#~#~#~~~~~~~#~###~~###~##~~#~~##~######~~#~#~##~######
#########-#------------##----#-########-#####--...##-##-#..~#######~##~~~~##~#~##~~~###~####~#~#~~~~~#-#---##-##-###-######--##--##-#-###-#-#~~##~#~#~#~############~##~~~~~##~##~~~#~~###~#~~~~#~#~####
#---------#-#-##-#-#-#-#####-#####---#####--##-#-##--#--##.##~#~##~~~####~~#~#~~###~~##~##~~~###~#####---####-#----#-##---##--#-##------#---##~~#~#~#~~~~~~~~~~##~#~~##~#####~~~##~##~##~#~~~##~#~#~~~~#
#####-#-#---####-###-###------##-###---#-##--#############.#~~~~##~####~##~#~#~##~~~##~~~#~####~~###-#-###-#--##-###-#--###--##--###-####-###~~##~#~~~###~#~#~##~~#~##~~##~##~####~~#~~#~#~#~~#~#~~~##~#
##-###########---#-----##-#####------#----##-##-#-#-#-##--...#####~~##~~~#~#~#~##~#~~###~~~~#~##~~~#-#-##--#-##---##---##-#-###-##-#--##----##~~~~~~#############~#~~#~##~~#~~~~~~~##~##~#~#######~#####
#---##-##------#-##-##-##-#-----#-##-####----#---------#-###..##~##~~###~#~~~#~####~##~~~#~##~#~~###-#--##-#-###-####-##------#-##---###-#####~###~####~##~#~###~~##~~~~##~#~#~#~#~~~~~~~~~~##~##~~~~~~#
##-##---###-##-#--####--#####-#########-##-#-########-####-##.~#~~#~##~~~~~###~~##~~~###~####~#~###----##--#--#--#-#--##-######----###-#-#-##~~~####~~~~~#~#~~#~~##~~#####~#~######~###~###~~~~~~~#~#~##
#--####--#--##-##-#--##-##----#---------------###------##--#~.##~##~####~#~~~##~###~##~#~~##~~~~#~#-#-####-#-##-##---###--#-###-##-----#-#-##~###~###~####~##~~~####~~~##~~~~~#~##~~~~#~~~#~##~#~##~####
##---###-#####-#--##-------#-##-######-######-#-######-###-##.##~~#~#~######~##~#~#~##~#~####~###~###-#--#---#---###-#-#-##-#-#-########----#~#~~~~#~~##~~~##~###~#~~###~~###~~~~###~##~##############~#
#--#-#----##-####--###-###########-----##---------------##-#-..##~~~~~~##~##~##~~~#~##~~~~##~~#~~~##--##-#-###-###-------##-#-#-#-#----##-###~~~##~~~##~~####~~##~~~##~##~~~#~####~###~~~~~~~~~~~~~##~~#
##-######----##-##-#####~##-#-##-#####-################------#.##~#######~#~~~###~#~####~##~~##~#####------#-#-#-###---###----------#####---#~######~~##~~#~##~~##~###~~#~###~~~~~~~~##~###~###~####~~##
#--##-##--####--####~~#~~##-#-#--------#-----###--#--####-#-##....~##~##~~##~##~#~~~#~##~~##~##~~~#~#-####---#---####-##-#-###########----#-#~#~#######~~##~~#~##~~~~##~#~###################~####~#~###
##--#-###-#-#--##-###~~~##----#######-####-#---##-##------###--##.##~~###~~~~~#~##~##~~~~##~~~#~###~####-###-#-###--#-#----##-####-----#-####~~~~#~~~~##~##~##~##~####~~~~~~~~~######~~~#~~##~~#~~~~~~~#
###-#-#-#-#-#-###-#~###~###-#---##-####-######-#-----##-#-######-..##~~######~#~##~#####~~##~##~~#~~##---##------##-----#-###------###-#-#~##~##~#~#####~~~~~#~~#~~#~#~#########~~~~~~###~####~~~#######
#-----------#-##--#~~~~~#~#####-##--------#-##---#-###--#-#---#--#....##~#-#~~#~#~~~~####~~~~~##~~~####-####-###--##-#######--####---#####~~#~####~~##~#~#####~##~##~~~~~~###~~~~######~~~~##~~#~###~~~#
#-#######-###--##-###~#~~~##-------##-###------#-#-#---##-###-##-#-##..~~#-##~~~####~~~~##~######~##--#---##-#-####---##-----##########~##~##~~~##~###~#~##~~~~~~~~##~###~~~#~####~##~#~######~###~#~###
#--##-----#---##--##~~###~~#####-#-######-#-##-#-#-##-######--########.###-#~~###~~#~####~~#~##~#~~##-###-##----##--###--#####~~~####~#~##~#~~####~~~#~#~##~#########~~~#####~~~##~#~~~~~~~#~#~~##~#~~~#
########-##-#####--######~##~#######~#----#-####-#######-#---##-#-#-##.##--##~#~##~~~~#~##~#~#~~~~##---#--##-######---#-###-###~##~~#~#~#~~#~##~~~~###~~~~~~~##~###~#~#~##~~~~###~~~~###~###~~~###~#~###
##-#------#--##-##---##~~~~#~#~##~##~######-#-#####------###----#-#-##.~##-#~~~~~##~###~~~~#~~~#######-##-#---#####-###------#~~~~~##~~~##~~~~#~####~#~#####~~~~~~~~~~#~~~~##~~~#~##~~~#######~#~#~#~###
#--######-#-##--##-#--####~#~~~~#~~~~##~##--#---#-######--###-#-----##.###-##~#####~~#####~#~###--#-#--##-#-###-##------#-##-#~#####~~###~~####~~~##~~~####~~#~##~##~###~####~###~~#~#~~##~#~~~#~~~~~~~#
##-#-#----#-###-##-####~##~####~~~##~~~~~######------####-----#-###---........#-##~~##~~~#~~~~#--##-#-##--#-###--##-##########~~~#~~~##-##~#~#~~#~##~#~~~~#~##########~####~###~~~########~#~###~###~###
#------##-#-#-#-#---##~~~~~~~~~~#~######~#~#~#######------#-#-#--###-######-#.#--##~####~~~##~#-##--#-###-#-#-##-------#-##-#~~###~#~#--##~~~~~#######~#######~~###~#~~##~~~~~##~###~~#~#~~~~##~~~~#~~~#
####-#-#----------#######~#~#~#~#~#~~~~~~~~#~~###-#######-###-#-##-#####-####.#-##~~#--###~~###--##----##-#----##-######-#--##~~~~~#~#-##~~#####~#~##~~~#~##~##~~~#~~~###~######~~~##~~~#~####~~#~##~###
###--#-#-#-######------#############~#~#~#~~~##~#-#-#---#-##--####-##-----##-......##-##~~~#####--####-##-#-#####----------##~~#######-###~~~~~~~~~####~~~#~~~##~##~###~#~~#~##~~####~###~#~~~~##~~#~~~#
#-##-############-######-#--#####--###~#####~~#~#---###----#-###------###----#####.##--###~#~~##-###-#-#-----##-#-############~#~#~~##--##~#########~~~~###~####~~~~#~#~##~#~#~~##~~#~###~~~##~~#~###~##
#----##-----------##-#-#---##-#-##---####~###~#~###--#--#-####---##-#-#####-##----..##--##~#~##--#---#-#-#####-------##--#-#-#~~~~~##--##~~~~~#~~~~##~#####~~~~#~####~~~#~~~~~~####~#~#~#~#####~#~~#####
#-#-####-##-#-#-#-##-#-###------###-####~~~##~#~#~##---##--##--#-######------######.##-##~~#~~##-###---#---##--#######--##-#-##~######--##~####~#####~~~~~#~####~##~#~#~~~##~####~#~#~#~~~~~#~######~#~#
#-#--#-###--###-#--#-#-#-#-##-#---#-##~~~#~~~~#~#~~###-##-###-##-#~#~##-###-##-----.......##~##----###-#-###--##-##-###-##-#...~~~#~#--###~##~#~#~##~~#####~#~#~~~~~~~######~##~#~#~~~~~#~#~~~~#~#~#~~~#
#-####-###########-#-#-#-########----######~#~~~~~##---####----###~~~~########-###-######.##~~####-##--#--#--##---#-#~#......#.##~~~##--#~~~#~~~~~##~##~#~#~#~#~#####~~~~~~#~~~~~~~~#~#~########~#~#~###
####-#-#--###-##-#-#-#-#--#-##----#####-#~~~###~#~##-###~####-###~~##~###~~#~###~####--#-..##~~##--###-#-##-##--###-#~#.####-#.#######-##~###~#####~~~~~~~~~~~~~~~~~#~#~#~##~#####~##~#~~#~#####~~~~~~~#
#------##-#----------#-#-##-###-#--#-#--#########~#####~~~#####~##~#~~#~##~#~~#~~##~##-###..##~~##--##---##-##-##-#-#~#.######...##.......~~~~~~~~~~##~##~#~#~##~##~#~#####~~~~~##~####~##~#~~~##~###~##
###-##----####-#-###---#-##-#-####---##--###~~~~~~~##~##~##~##~~#####~~~##~##~##~##~##-#-##..~~##--#####..............#.~~~~~###....#####.######~#######~~#~#~~####~#~##~####~#~##~~~~#~##~#~#~##~~~####
#####--##------#-#---#---#----##---#####---####~##~~#~#~~##~#~~##~##~~#~~~~~~~~~~~~~#--#-###.#####--##...#-#-#-###-##...#~#~##---##----##......######~###~####~~~~#####~~~~##~#~~#~####~##~~~#~##~####~#
#--#--####-###-#-###-#-#-##-#-####--##---####-#####~~~#~##~~~~##~~~##~##~##########~##---#-#..#-###--#.#########----##-####~##-#--##-#####-#-#..#~~~#~#~#~~#~##~####~##~####~~#~#####~###~~#####~~~#~#~#
##---##----#---#-#---###-##-###-###--###-##----#-####~#~~####~~~~#~########-##-##~#~####-#-##.#---##-#.~~##-#-##########-########-##-##-##-#-##..~#~~~~~##~~~~~~~~~~~~~~~~###~#~~~~~~~~##~##~##~~###~#~#
#--#--###-##-#-#-##-##---##--##--###-###--##-###-#~~~~~~###-####~###-##~#~#----#~~~~#~~....#..#-###....####-#-#-----###----##-#-###------#-#####.######~##~#~#~######~#~###~###~######~~~~~~~~~~####~#~#
#-###-##---#############-##-####-#-----##-##--##-####~#.....###~~~##--#~~~####-####~###.##...##-#-#.##--#-#-#-#-###--#--##------#####-#-######--...######~~#~#~~~~~~#~#~~~~~~####~##~#####~#~##~~~~~~~~#
###------#--#-#-------#------##--##-##-##-##-##---#-###.~##.#-###~~##-###~~#....#-#.....~###--#-#...#####---------##---##--######-#######-#--#-#-#......######~##~#~###~##~#~~##~~~~~~######~~#~#~#~#~##
#---###-##-##-#######-######--##-#####-#---#-####----#~.##~....###~~#-#~##...##.....#-##~####--...###-#-#-####-#-##--#-###---##-#----#-##---####-#-#-##...~########~~~#~##~##~~~~####~~~~~~##~#~###~#~~#
######---####-#-#-#-#-#-##-#-###-#-#-#-###----#-####-##.~###-#..###...~~##.#-#--#-#-######-####.#--#---------#-#--##-#--##-#------##---#--###-####-#--#-#.##~~~~###~###~##~###~#~~###~#~#######~~~###~##
#------#-#---------------------------#-#---##--------##.#######.....#.#~#..######-#-#---#----#..##---###-#######-##--##--######-########-##---#--#-#-####.##~####~#~~#######~~~####~###~~~~~~~##~##~~~~#
###-#-##-#########-#####-#-####-####---###--###-##-#---..#~##~##-##-#.....###-##--#####---##...####-####-------#--#-####--#--##########-----###-######--#....~~~~~##~~~##-##~#~~##~~~##~#~#~###~~~##~#~#
#---######---------##----#####---##--#-----###--#####-##...#~~~#############-----##-----#-#~.#--##-----###############-##---##-#--##----##-##-#-----#--#####.##~########---#~##~~~~###~~###~~~###~#~~#~#
#######-##########-#--####-----#-##-##-###---##-#-----##-#.#~###--#------#~####-#######-#-##.#-###-#-#------#-#--#-##--#--####-#-##--####---#-#-#####-##-##-..#####-##-##-#####~#~#####~~###~##~~~#~##~#
#--------##---#-#####-#----##-##--###----###-#--##-#######...#-##-######...#-##-#-##----####.###---###-##-#-----##--##-##----#-#-#--#######-----##----------#...............#~#~#~~~~~##~~~#~~##~##~##~#
#####-##----#----#----###-##--##-###--##############-#-##--#.............#....###-#--#-###...~~#-#--##########-##--##--####-##-----###----#-#-#--#-##-##-#-##-#####-#######.#~#####~#~##~#~##~##~~#~~#~#
#-----#--#####-#---#####---########--##-----#-###-#--#-#--##-##-##-##########.##--######...##~#####----------#--#-####-#-#####-###-----#-##-####----#########-----#-----##~.~~#######~####~######~#~##~#
#-#-#-######-#-#-#-##----#-#----#---##--#-#-----#-##-----##--#--##-#----#-##-..##---#....#-#~~##----#####-#-###-#----------#----##############-#######--#-#-#####---#-#####.###-#~#####-##~#-#-#########
#######--------#-#######-#-####---#--##-#####-#------##-####-#-########------#.####...#-##-##~~####-----###-##----#-#-#-#-##-##---#-----#-#-----##-#-##------#-########-#-#.#.....#-##---###----##-#---#
##-#-###############-----########-#-##--#-----#-##-#-#---##--#-#--------###-##......#-#--#####~~##--##-####--###-####-#-#----####---##-##-##-####-------#-##-#-#-#-#-#-----...#-#....###--#--####----#-#
#-----#-###-###-##-##-######------#--#####-######--#####-##-##-#######-##---#######-#-#-##~~~##~###-##-#--#-##------#####-##----##-######--#-#----#-##########-#-#-#-#-####-#-####-#.#-#-##-##-##-######
#####-#---#-----##--#####----##-##############--#####-#--##-#--###------###-#-------#-#-##~#~~~~~~###----##--###-#-###-##-##-#######-##---##-#-####---##-#--##---#---#-#-#######-###............#-###~##
#-----###---#-#----###----##-##-##-#-#--#-#----##-------#####-##---###-##---#-##-#-####--####~#~#~~##-#-#######--#-----##-##--##-##---#-###-----#####----#-##--#---#------#####---####-######-#....~~~~#
##-##-#---#-####-#-----####--#--#----##---####-####-#-#-##-##-#--###-###--######-#----#####~~~#~##~##-#-#-----##-##-##-######-------###-#---###---###-####-##-######-######-#-#-###-##-##-########.#####
#####-#-#-#---#####-##--######-#####----#--#--------###-#-----#####------###-----###-##~~~~~###~####--#---##-##--##--#-----##-#-###-----#-#---###---####-#-#-----------------------------------###.##-##
#-#-----###-###-######-##------------##-##---#-#-##---###-#-#-###-######-##--#-#-#----##~#~##~~~~~~##-#-#-##########-##-#-###-#--##-#-#---##-##---###--#-----####-###-##-######-####-#-#########...~#--#
#---#-#--##-##---#-#---##-#-#-###-#-###-###-####-##-#######-#-#----##-----##-#####-#-##~~#~~###~#~###-#-#---#-#---#####-#---###-##--###-#--###--#---##---#-#----#--##--#-----#####-###---####-##.####-##
#-#-###-########-#---#--#-###--##-#-##--#---##---##-##------#-####----##-#####-----#--##~#####~~###---###-###-#-###---#-##-##---###-----###########----###-###-#######-#-##-##-##----#-###-----#.......#
###-##--##----#----#########--##--#####-#-###--#-##-###-#-########-#-######-######-#-###~#~~~##~~##-#--##-----------#---##--###--##-#-#---##-###-###-#---####-------##-#-##-#--###-###-----#-#---##-##.#
#---###--####---##-##-#-##-##-##-##-----#-#---####---##-####-##----#-##------------#---###~#~~~~#####-##--###-#-##-##-#-###--##-#####-#-####---------#-#----##-####-##-####---##-#-#-##-#-####-#--#--#.#
#-#-----##----#--#-#-----------#--##-#-##-##-##----#-#--##------#-##-#--#-##-#-#-#-#-#-##~~##~#~~~##---##--##-#-##--#-#---##-##---##--#------##-#-##-#-#-#-##----##--#-##---#-----------#---##-#-##-##..
######################################################################################################################################################################################################@#
