#.##################
#...............~~##
#####-##-##-###.#~~#
#-###-#--##-##~.#~##
#-#---#########.#~~#
#---#----#-##-#.####
#-####-#-------...~#
#-##---##########.##
#----#--##-------...
##################@#
